无	一尢
独	犭虫
有	十月
偶	亻禺
卓	卜早
成	戊㇆
效	交攵
急	刍心
功	工力
近	辶斤
利	禾刂
万	一勹
失	丿夫
惨	忄参
不	一个
忍	刃心
睹	目者
自	丶目
古	十口
以	厶人
来	一米
力	丿㇆
更	一曳
生	牛一
中	口丨
上	二丨
而	干川
下	一卜
二	一一
赏	尚贝
心	儿刂
悦	心兑
目	日一
可	丁口
多	夕夕
得	彳㝵
大	一人
小	八丨
三	二一
四	口八
马	与丨
到	至刂
功	工力
意	音心
九	亅乙 
牛	丶干
毛	已二
如	女口
火	丷人
荼	艹余
来	一米
去	土厶
久	人人
之	丶乙
知	矢口
觉	兴见
点	占心
滴	氵啇
模	木莫
样	木羊
实	宀头
在	亻王
全	人王
赴	走卜
各	夂口
种	禾中
既	艮旡
往	彳主
事	古聿
求	亠水
是	日疋
草	艹早
下	一卜
王	一工
干	一十
日	一口
王	一干
王	一土
员	口贝
宋	宀木
尤	尢丶
香	禾日
肤	月夫
佯	亻羊
穴	八宀
勺	丶勹
十	一丨
个	一人
徒	走彳
云	二厶
木	十八
早	十日
旱	日干
本	一木
杏	木口